11111100111111
12222100122221
12332100123321
12332100123321
12222100122221
11111100111111
00000000000000
00000000000000
00111111111100
11111111111111
11111111111111
00111111111100
00000000000000
00000000000000
11111100111111
12222100122221
12332100123321
12332100123321
12222100122221
11111100111111